NO ./textures/BRICK_WALL.xpm
SO ./textures/PLANT_WALL.xpm
WE ./textures/STONE_WALL.xpm
EA ./textures/WOOD_WALL.xpm

F 50,120,100
C 40,230,200

1111111111111111111111111
1E00000000000000000000001
1000000000000000000001001
1000000000000000000010001
1000000000000000000100001
1000000000000000001111111
1000000000000000000000001
1000000000000000000000001
1000000000000000000000001
1000000000000000000000001
1000000000000000000000001
1000000000000000000000001
1000000000000000000000001
1111111111111111111111111