SO ./textures/BRICK_WALL.xpm
NO       ./textures/PLANT_WALL.xpm
WE ./textures/STONE_WALL2.xpm
EA       ./textures/WOOD_WALL.xpm

F       220,100,0
C 0,30,200

        1111111111111111111111111
        1000000000110000000000001
        101100N001110000000000001
        1001000000000000111111111
1111111110110000011100001         
1000000000110000011101111          111 
1111011111111101110000001         10001
1111011111111101110101001          111 
1100000011010101110000001
1000000000000000110000001
1000000000000000110101001
110000011101010111110111111111111
11110111 11101000000001  10111101
11111111 111111111111111111111111