1111111111111111111111111111111111
1000000000000000C00000000000000001
100000000000000C0C0000000000000001
10000000000000000000000010C0000001
10000000000000000000000010C0000001
100000000CC000000000000010C0000001
1000000011100000000000000000000001
1000000000000000000000000000000001
1000000000000000011010000000000001
1000000000000000000P00000000000001
1000000000000000000000000CC0000001
1000001110000000011000000000000001
10000000000CC000000000000000000001
1000000000011000000000000000000E01
1111111111111111111111111111111111