1111111111111111111111111111111111
1000000000000000000000000000010001
10011100000001000000P00CCC00010E01
10000000000001000000000CCC0C010001
1111111111111111111111111111111111