1111111111111111111111111111111111
1000000000000000000000000000000001
10011100000001000000P00CCC00000E01
10000000000001000000000CCC0C000001
1111111111111111111111111111111111