1111111111111111111111111111111111
1000000000000000000000000000100001
10011100000001000000P00CCC00100E01
10000000000001000000000CCC0C100001
1111111111111111111111111111111111