1111111111111111111111111111111111
1000000000000000000000000000000001
10000000000000000000P00CCCCCC00E01
10000000000000000000000CCCCCC00001
1111111111111111111111111111111111